NO               tex/Bark.xpm          
SO tex/Stone.xpm
EA tex/TreeRings.xpm


WO    tex/Grass.xpm              
 
  
   
    
     
      

       
        
         



F 220,100,0



        C 156,255,255   
      1111111 111111111111111111      
      1111111111111111111110111111111111
      10000010001000000000N0000000000001  
      1000000100010000000101111111111111
      100000001010000000001 
      100000000100000000001       
     10000000000000000000011     
    11111111111101111111111111
11111111111 11111111111111111
1111111 111111111 111111111







              





